39
S##....................................
..#.##################################.
#.#........#.........................#.
#.########.#...............######....#.
#........#.#...###########......#....#.
#.######.#.#...#.........#......#....#.
#.#....#.#.##..#.........#......#....#.
#.#.##.#.#..#..#...#..#..#......#....#.
#.#..#.#.#..#..#.........#......#....#.
#.####.#....#..#...#..#..#......#....#.
#......#.#..#..#....##...#......#....#.
########.#..#..#.........#......#....#.
.........#..##.#.........#......#....#.
####.#####...#.#.........#......#....#.
...#.#.......#.#.........#......#....#.
.#.#.#.......#.#.........#......#....#.
.#.#.#.......#.##........#......#....#.
.#.#.#.......#.###.....###......#....#.
.#.#.#.......#.###########......#....#.
.#.#.#########.###########......#....#.
.#.#...........########....########..#.
.#.##############.####....####....#..#.
.#....####....###...#........#....#..#.
.######..######.#...#........#....#..#.
.##............##...#........#.......#.
..............##....#........#.......#.
...####......##.....#........#.......#.
..#...###...##......#........#.......#.
.#.......#.##.......#........#.......#.
#........###........#........#.......#.
.........##.........#........#.......#.
.......###..........#........#.......#.
......##............#........#.......#.
.....##.............#........#.......#.
....##..............#........#.......#.
....#...............#........#.......#.
....#...............#........##......#.
....#...............#........##########
....#...............#.................G
