8
........
..####..
..#..#..
..####..
...#....
..####..
..S#G...
..#.#...
