16
...............G
................
................
................
....#####.......
...#.....#......
...#.#.#.#......
..#.......#.....
..#..#.#..#.....
...#..#..#......
...#.....#......
....#####.......
................
................
................
S...............
