60
............................................................
............................................................
............................................................
............................................................
............................................................
............................................................
............................................................
............................................................
..........S.................................................
.................####.......................................
.......###.#.#...#####...#...#..#...#.#..#..................
.................#.#.......................##...............
................#.###.......................##..............
...............######.......................##..............
...............#.##........................#................
...............####.....................#...................
................#....................#......................
................#.#.....#...#....#..........................
.....#...#..#...#...#.......................................
###..............#..........................................
####.............#.##.......................................
####.............#.#........................................
#..#...#....#...##.#........................................
#...............###..#......................................
#...............#......#..#.#...............................
#..............#.......#...#.#..............................
#............#...#.#.#..##..................................
#...........#.##.#..........................................
##........##................#.#..#.##.##.##.................
.#........#...........#..#.................#................
..##......####..#.#.........................#...............
...#........................................#...............
...#........................................#...............
....#.......................................#...............
....#.......................................#...............
....#.......................................................
....#.......................................#...............
....#......................................#................
....#.....................................#.................
....#.............................#..#.#.#..................
....#....................#.##.#.#...........................
....#..................##...................................
....#..............####.....................................
....#............#.#........................................
....#..........##...........................................
....#........##.............................................
....#.......#...............................................
....#......#...................#.#.##.......................
....#......##......#.#.#.#.#.#.......###....................
.....#.......##.#.#....................#....................
.....#.................................#....................
.....#.................................#....................
.....#.................................#....................
.....#................................##....................
.....###.....................G........#.....................
.......################################.....................
............................................................
............................................................
............................................................
............................................................
