10
.........G
..........
.###..##..
..........
..........
##.#####..
..........
..########
..........
S.........