64
................................................................
................................................................
................................................................
................................................................
................................#####...........................
.................#####.........##...#...........................
................##..............................................
................................................................
...............................#####............................
.............####.............##...##...........................
...........##...###.##.......##.....##..........................
.........###......###.###...##..##...#..........................
.........######...#.....#####...###..##.........................
..............###.#.......##....###...#.........................
................###....##..#....###..###........................
.................##....###.##.........#.##......................
...............###.....###..##.......#....##....................
.............##..##.........###...###......#######..............
............##....#........#...####..............#####..........
............#.....###.....##..........................##........
............#..####.####.##.............S...............##......
............#####.##...###...####..#..................###.......
...............#.##....#......#.#.##...............###..........
..............#.#.......#.....#...#..............##.............
..............##........#.....#..#.............##...............
..............#.........#.....#.#.........#####.................
........................#.....##......####......................
........................#...........##..........................
........................#.........##............................
........................#......###.............#####............
.........................#.#####.############..#...#............
........................####...##....#.......##....#............
.......................###....####.########.##....##............
......................####.....#######........#####.............
...................####.##......#...##..........................
..................#.###.##......#...............................
................##.##....#..G...##..............................
................#.##...###.......#..............................
.............##..#######.#........#.............................
............##..####..###.........#.............................
................###..####......###..............................
................######.#.#######.##.............................
.................#.##...#..#.#...#.#............................
.................###.......#.#....##............................
........................#..#..#....##...........................
........................#..#..##...##...........................
........................#..#...#....#...........................
........................#..#....#...##..........................
........................#..##...######..........................
........................#####........#..........................
.........................####.......##..........................
..........................##........###.........................
.....................................##.........................
................................................................
................................................................
................................................................
................................................................
................................................................
................................................................
................................................................
................................................................
................................................................
................................................................
................................................................
