22
.........#####.......G
...######.....##......
...#...........#......
...#...........#......
...#.....############.
.########.......#.....
##.##...........#.....
...##.....#.#...#.....
...##.....#.#...#.....
...##.....#.#...#.....
...##...############..
...##...#..........#..
...##...############..
...##...#......##.....
...##...#########.....
...##...........#.....
...##...........#.....
..###...........##....
.#.##...........##....
#..##...........#.##..
...##...........#..##.
...##...S.......#...#.
