9
........S
.........
.........
.........
.........
.........
.........
##.......
G#.......
