9
.....#..G
.###.#...
...#.###.
####.....
....S....
.##..###.
..##.#.#.
...#.#.#.
...###...
