44
############################################
#G...#.....................................#
####.#.#############...######.##############
##...#.#....................#.#............#
##.#.#.####################.#.#............#
##.#.#.#.............######.#.#..######.####
##.#.#.#..........#..#......#.#..#.........#
##.#.#.############..#.######.#..#.#######.#
##.#.#...............#.#......#..#.#.....#.#
##.#.###.#############.#.######..#...###.#.#
##.#.....#.............#.#......####.###.#.#
##.#.....#.###.###.....#.###.......#.###.#.#
##.#########.....#######...######..#.###.#.#
##.........#.......#............#..#.###.#.#
##.#######.#.#######..########..#..#.###.#.#
##.#..#.##.#.#.....#..#......#..#..#.###.#.#
####..#.##.#.#....######.###.#..#..#.###.#.#
##....#.##.#.#....##S..#.#.#.#..#..#.###.#.#
##.##.#.##.#.#.#######.#.#.#....#..#.###.#.#
##.##.#.##.#.#.#.....#.#.#.#.#..#..#.###.#.#
##.##.#.##.#.#.#..##.#.#...#.#..#..#.###.#.#
##.##.#.##.#.#.##.#..#.#####.#..#..#.###.#.#
##.##.#.##.#.#..#.#..#.......#..#..#.###.#.#
##.##.#.##.#.#..#.####.#####.#..#..#.###.#.#
##.##.#.##.#.#..#......#.....#..#..#.###.#.#
##.##.#.##.#.#..######.#.###.#.....#.###.#.#
##.##.#.##.#.#.......#.#.###.#.....#.###.#.#
##.##.#.##.#.#######.#.#.###.#######.###.#.#
##.##.#.##.#.#######.#.#.............###.#.#
##.##.#.##...........#.#################.#.#
##.##.#.##......######.#.................#.#
##.##.#.#########......#.#################.#
##.##.#.##############.#.#...............#.#
##.##.#................#.#.#############.#.#
##.##.##################.#.#...........#.#.#
##.##....................#.#.#########.#.#.#
##.##.##################.#.#.#.......#.#.#.#
##.##..................#.#.#.#.........#.#.#
##.#####################.#.#.########..#.#.#
##.##....................#.#........####.#.#
##.#######################.########......#.#
##.#######################........########.#
##.........................................#
############################################
