10
.........G
..........
########....
..........
..........
########...
..........
..########
..........
S.........