64
################################################################
#...........................................................#S#G
#...........................................................#.#.
#...........................................................#.#.
#.................##############.........................#..#.#.
#............######..........#..#######..............##..#..#.#.
#...........##...........#######....###################..#..#.#.
#.........##.........####.......###..................##..#..#.#.
#.........#......####.............#####.............#.#..####.#.
#........#.....###..................#.#............#..#.......#.
#.......##....##......########..........#.........##..#.......#.
#.......#....##...#####......######......#.........#.##.......#.
#......##...##...##...............###.....#.......#..##.........
#......#...#....##..................##......####..#..#........#.
#......#..##...##....................##........####.##........#.
#......#..#....#............############...#.###.#..#.........#.
#......#..#...#..........###...........##.#.#...##.#..........#.
#......#.##...#........##...............##..#...##.#..........#.
#......#.#...##......##................##..###...###..........#.
#......#.#...#.....###..............#####....####..##.........#.
#......#.....#.....###...........####....#.....####.#.........#.
#......#.#..##....##.###........#........#......#.###.........#.
#........#..#.....#....#.......##....#...#......#.............#.
#......#.#..#.....#....##.....##.....#...#.....##.............#.
#......#.#..#.....#.....#....##.#....#...#....###.............#.
#......#.#..#.....#.....#...#...#....#...#..###.#.......#######.
#......#.#..#.....#......####...#....#...#.##..##.....##......#.
#......#.#..#.....#......###....#........#.#..###....##.......#.
#......#.#..#.....#........#....#.......#.#...#.#...#.........#.
#.....#.....#.....#.......##............######...#.#..........#.
#.....#..#..#.....##......#............##.##.....#............#.
#.....##....#......#.....#............#####.#....##...........#.
#.....#...#.##.....#######...........#####...#...##...........#.
#......#..#..###...##..#..###.....###...#....#...#.#..........#.
#......#..#....####..#.#....#######.....#....#..##.##.........#.
#......#..##...#..#....#...#............#....#..#...##........#.
#......#...#...#..#..###...#............#...#...#.....#.......#.
#......#...##...##....##...#..........####..#...#......###...##.
#......##...##..##.....#...#......####...#.##...#.........#####.
#.......#...#..#..#....###.#######.......###.....#..........#...
#.......##...#...###...#####..............###....#.........##...
#........#........######...#.............####....#..........#...
#........##...#...##..##...#...........###.###....#........##...
#.........##...#...#####...#############...##.....#........#....
#.........##...##......#...#..............###.....#.......##....
#...........###.###....#..#.............###.##...##.......#.....
#............#.#..###..###.##..........##.....#.##....#....#....
#............#.#.....##..#####.......##.......###....##....#....
#.............##........##...############......#....###...#.....
#..............##.....##........##....###########.##..##.##.....
#..............#####.##.........#.......#.......##.....###......
#..................###.........##.......#................#......
#.....................#......##.......####...............#......
#......................##.#############..#..............#.......
#........................................##.............#.......
#.........................................##..........##........
#..........................................##........#..........
#...........................................####.....#..........
#...............................................#####...........
#...............................................................
#...............................................................
#...............................................................
#..........................................#####################
################################################################
