17
......#....#.....
......#....####..
....###..#.#.....
....#....#.#.####
.#########.#.....
........#G.####..
######..####..#..
.....#..#..#..#..
..#..#..#..#..#..
.##..#..#.....#..
..#..#..####..#..
..#.S#..#.....#..
.#####..#######..
.....#..#.....#..
.#####..#.....##.
.#.....######.#..
.................
