9
...#G....
.#.###...
.#.....#.
.###.####
.#.......
.#.#####.
.#.#...#.
.#.###...
.S...#...
