17
......#..........
......#....####..
....###..#.#.....
...S#....#.#.####
.#########.#.....
........#G.####..
######..####..#..
.....#..#..#..#..
..#..#..#..#..#..
.##..#..#.....#..
..#..#..####..#..
..#..#..#.....#..
.#####..#######..
.....#..#.....#..
.#####..#.....##.
.#.....######.#..
.................
