13
............G
.............
.............
.............
....#####....
...#.....#...
...#.#.#.#...
..#.......#..
..#..#.#..#..
...#..#..#...
...#.....#...
....#####....
S............
