39
.............#####.....................
...........##...###....................
..........##.....#######...............
.........##.......########.............
........##........###...###............
......##.........##.....####...........
....##........###........####..........
...#..........#............####........
..#........##...............####.......
##........##.................####......
........##....................####.....
.......##..........#########...####....
......##.....######.....####...####....
.....##......#............##...........
....##.......#............##......###..
....#........#............##......###..
....##.......#...#######..##.......###.
.....#........#.....S.##..##........##.
.....#........#.......##..###......###.
......#.......#.......##..###.....###..
......#.......####....##...###....##...
.......#.........#######...###..###....
.......#...........####....###..##.....
.......##..................###.##......
.......###.................#####.......
.......#.#................######.......
.......##.##..........#########........
........#..#.......##########..........
........##..#.##############...........
.........#...######.....###............
#........#.............###.............
.#........#...........##...............
..#.......##.........###...............
...#.......##.......###...............#
....#.......##.....###...............##
.....##.......##..####.............###.
......##.......#######............##...
.......##........#################.....
........##............................G
